"filename", "language", "Python", "HYCON Assembly", "comment", "blank", "total"
"/home/cypooos/code/TIPE/matrix_processor/distance_test.py", "Python", 114, 0, 1, 22, 137
"/home/cypooos/code/TIPE/matrix_processor/main.py", "Python", 72, 0, 0, 18, 90
"/home/cypooos/code/TIPE/matrix_processor/matrix.py", "Python", 91, 0, 4, 17, 112
"/home/cypooos/code/TIPE/matrix_processor/matrixProcessor.py", "Python", 148, 0, 2, 41, 191
"/home/cypooos/code/TIPE/matrix_processor/reader.py", "Python", 153, 0, 0, 33, 186
"/home/cypooos/code/TIPE/matrix_processor/tests/arithmetics.asm", "HYCON Assembly", 0, 17, 0, 3, 20
"/home/cypooos/code/TIPE/matrix_processor/tests/distance.asm", "HYCON Assembly", 0, 40, 0, 11, 51
"/home/cypooos/code/TIPE/matrix_processor/tests/distance_mem.asm", "HYCON Assembly", 0, 57, 0, 13, 70
"/home/cypooos/code/TIPE/matrix_processor/tests/is_cycle.asm", "HYCON Assembly", 0, 32, 0, 8, 40
"Total", "-", 578, 146, 7, 166, 897